111121111
100000001
200000001
100000001
100000001
100000002
100000001
111121111
&