1111211111111111111111121111111
1000000000000000000000000000002
1000000000000000000000000000001
2000000000000000000000000000001
1000000000000000000000000000001
1000000000000000000000000000001
1000000000000000000000000000001
1000000000000000000000000000001
1000000000000100000000000000001
1000000000000100000000000000001
1000000000000100001000000000002
1000000000000100001000000000001
1000000000000111111000000000001
1000000000000000000000000000001
1000000000000000000000000000001
1000000000000000000000000000001
1000000000000000000000000000001
1000000000000000000000000000001
1000000000000000000000000000001
1000000000000000000000000000001
1000000000000000000000000000001
1000000000000000000000000000001
1000000000000000000000000000001
1111211111111111111111111111111
&
1111111111111111111111112111
1000000000000000000000100001
1000000000000000000000100001
1000000000010000000000100001
1000000000010000000000100001
1000000000010000000000100001
2000000000010000000000000001
1000000000010000000000000001
1111111111111111111112111111
& 
   11211
   10001
11110001111
10000000001
20000000002
10000000001
11111211111
&
111112111111
10000000000111111
10000000000000001
20000000000000001
10000000000000002
11111111121111111
&
   11211
   10001
11110001111
10000000001
20001110002
10000000001
11111211111
&
   121
  11011
 1100011
110000011
200000002
110000011
 1100011
  11011
   121
&
11211      11211
10001      10001
10001      10001
1000111111110001
1000000000000001
1000000000000001
1000000000000001
1111111111112111
&
1211111111
1001000001
1000000102
1121112111
&
