1111211111111111111111121111111
1000000000000000000000000000001
1000011100000000000011100000001
100001 10000000000001 100000002
100001 10000000000001 100000001
100001110000000000001 100000001
1000000000000000000011100000001
1000000000000000000000000000001
1111211111111111111111111111111
&
1111111111111111111111112111
1000000000000000000000000001
1000000000000000000000000001
1000000001111111000000000001
1000000001     1000000000001
1000000001     1000000000001
2000000001111111000000000001
1000000000000000000000000001
1111111111111111111112111111
& 
   11211
   10001
11110001111
10000000001
20000000002
10000000001
11111211111
&
111112111111
10000000000111111
10000000000000001
20000000000000001
10000000000000002
11111111121111111
&
   11211
   10001
11110001111
10000000001
20000000002
10000000001
11111211111
&
     121
    11011
   1100011
  110000011
  200000002
  110000011
   1100011
    11011
     121
&
11211      11211
10001      10001
10001      10001
1000111111110001
1000000000000001
1000000000000001
1000000000000001
1111111111112111
&
1211111111
1000000001
1000000001
1000000001
1000000001
1000000001
1000000002
1121112111
&
111211
100001
100001
10000111111111
10000000000001
10000111100001
10000111100001
10000000000001
11111111100001
        100001
        100001
        112111
&


