
   111111121111111  
  11000000000000011
 1100000000000000011
 1000000000000000001
 1000111000001110001
 2000100000000010001
 1000100000000010002
 1000000001000000001
 1000000000000000001
 1000000000000000001
 1000000000000000001
 1000000000000000001
 1000100001000010002
 1000100000000010001
 1000111000001110001
 1100000000000000011  
  11000000000000011
   111111211111111   
&
11111211111111111
20000000001000001
10000000001000001
10000000001000002
10000000001000001
20000000001000001
10000000001000101
10000000000000001
20000000000000001
10000000000000002
10000000000000001
11111111121111111
&
1111211111111111111111121111111
1000000000000000000000000000001
1000000000000000000011100000001
1000000000001000000011100000002
1000000000001000000011100000001
1000011111111000000011100000001
1000000000000000000011100000001
1000000000000000000000000000001
1111211111111111111111111111111
&
1111111111111111111111112111
1000000000000000000000000001
1000000000000000000000000001
1000000001111111000000000001
1000000001111111000000000001
1000000001111111000000000001
2000000001111111000000000001
1000000000000000000000000001
1111111111111111111112111111
& 
   112111
   100001
11110000111111111
10000000000000001
10000000000000001
10000000000000001
20000000000000002
10000000000000001
10000000000000001
10000000000000001
11111211111111111
&
111112111111
10000000000111111
10000000000000001
20000000000000001
10000000000000002
11111111121111111
&
11211      11211
10001      10001
10001      10001
1000111111110001
1000000000000001
1000000000000001
1000000000000001
1111111111112111
&
1211111111111
1000000000001
1000000000001
1000000000001
1000000000001
1000000000001
1000000000002
1111112111111
&
111211
100001
100001
10000111111111
10000000000001
10000000000001
10000000000001
10000111100001
10000000000001
10000000000001
10000000000001
11111111100001
        100001
        100001
        112111
&
