111112111111
10000000000111111
10000000000000001
20000000000000001
10000000000000002
11111111121111111
&



